Abdul = Servidor
Ahmad = Muy alabado
Ahsan = Caritativo
Akil = Inteligente
Aladdin = Pináculo de la fe
Alim = Erudito
Asad = León
Assad = León
Atherton = De la ciudad por la primavera
Avery = Gobernante
Azeem = Defensor
Buckley = De la pradera
Chauncey = Canciller
Ferran = panadero
Feron = panadero
Ferryn = panadero
Ferris = Jinete
Fisk = Pescador
Grayson = Hijo del alguacil
Haidar = León
Hamal = Cordero
Iman = Creyente
Janan = Compasivo
Kadim = Servidor
Khadeem = Servidor
Kadin = Confidente
Kamal = Perfecto
Karif = Nacido en el otoño
Karim = Distinguido
Kasim = Dividido
Khalid = Eterno
Linford = Desde el Lime-Tree Ford
Malik = El mensajero del señor
Mustafa = Elegido
Nadim = Amigo
Nasser = Victorioso
Qadim = Antiguo
Qadir = Poderoso
Qamar = Luna
Rahim = Compasivo
Rashad = Líder sabio
Reshad = Líder sabio
Rigel = Pie
Salim = A salvo
Shaquille = Guapo
Tariq = Conquistador
Tarick = Conquistador
Vega = Estrella fugaz
Yardan = Rey
Zaim = general de brigada
Zimraan = Felicitar