Abdul = Serviteur
Ahmad = Très apprécié
Ahsan = Charitable
Akil = Intelligente
Aladdin = Sommet de la foi
Alim = Savant
Asad = Lion
Assad = Lion
Atherton = De la ville au printemps
Avery = Règle
Azeem = Défenseur
Buckley = De la prairie
Chauncey = Chancelier
Ferran = boulanger
Feron = boulanger
Ferryn = boulanger
Ferris = Cavalier
Fisk = Pêcheur
Grayson = Fils de l'huissier
Haidar = Lion
Hamal = agneau
Iman = Croyant
Janan = Tendre
Kadim = Serviteur
Khadeem = Serviteur
Kadin = Confident
Kamal = Parfait
Karif = Né à l'automne
Karim = Distingué
Kasim = Divisé
Khalid = Éternel
Linford = Du Gué aux Tilleuls
Malik = Le Messager du Seigneur
Mustafa = Choisi
Nadim = Ami
Nasser = Victorieux
Qadim = Ancien
Qadir = Puissant
Qamar = Lune
Rahim = Compatissant
Rashad = Leader sage
Reshad = Leader sage
Rigel = Le pied
Salim = En sécurité
Shaquille = Beau
Tariq = Conquérant
Tarick = Conquérant
Vega = Étoile filante
Yardan = Roi
Zaim = brigadier général
Zimraan = Louer