Abdul = Servo
Ahmad = Muito Elogiado
Ahsan = Caridoso
Akil = Inteligente
Aladdin = Pináculo da Fé
Alim = Estudioso
Asad = Leão
Assad = Leão
Atherton = Da cidade pela primavera
Avery = governante
Azeem = Defensor
Buckley = Do prado
Chauncey = Chanceler
Ferran = padeiro
Feron = padeiro
Ferryn = padeiro
Ferris = Cavaleiro
Fisk = Pescador
Grayson = Filho do meirinho
Haidar = Leão
Hamal = Borrego
Iman = Crente
Janan = Tenderhearth
Kadim = Servo
Khadeem = Servo
Kadin = Confidente
Kamal = Perfeito
Karif = Nascido no outono
Karim = Distinto
Kasim = Dividido
Khalid = Eterno
Linford = Do Lime-Tree Ford
Malik = O mensageiro do senhor
Mustafa = Escolhido
Nadim = Amigo
Nasser = Vitorioso
Qadim = Ancestral
Qadir = Poderoso
Qamar = Lua
Rahim = Compassivo
Rashad = Líder Sábio
Reshad = Líder Sábio
Rigel = Pé
Salim = Seguro
Shaquille = Jeitoso
Tariq = Conquistador
Tarick = Conquistador
Vega = Estrela cadente
Yardan = Rei
Zaim = General de brigada
Zimraan = Louvar