Acton = Asentamiento de roble
Addison = Hijo de Adán
Afton = De Afton, Inglaterra
Albert = Noble
Aldrich = Consejero sabio
Alfred = Gobernante benevolente
Allard = Valiente
Aric = Santo gobernante
Audie = Guardián de la propiedad
Baden = Bañista
Barker = Pastor
Barrie. = Tirador
Beldon = Del hermoso valle
Bentley = Desde el prado herboso
Bertram = Brillante
Bradley = Desde la amplia pradera
Bradlee = Desde el amplio prado
Brandon = De la colina llameante
Brandin = De la colina llameante
Brannan = De la colina llameante
Braxton = De la ciudad de Brock
Brock = Tejón
Buddy = Compañero
Byron = Del granero
Biren = Del granero
Calvert = Pastor de ganado
Camden = Desde el valle sinuoso
Carlise = Valiente
Carter = Conductor de un carro
Chester = Desde el Camping
Clayton = Desde Clay Estate
Clifford = Desde las alturas del río
Clifton = De la finca del acantilado
Clinton = Desde Hill Town
Dale = Desde el valle
Dalton = Del pueblo del valle
Dane = Corriente goteante
Dhane = Corriente goteante
Darwin = Amado
Dean = Valle
Edmund = Bendita paz
Edmond = Bendita paz
Edric = Potente con la propiedad
Edward = Nombrado para proteger
Eddy = Nombrado para proteger
Edwin = Amigo próspero
Elden = Guardián sabio
Eldred = Asesor de ancianos
Elmer = Famoso
Emmet = Serio
Emmit = Serio
Emmott = Serio
Esmond = Rico protector
Falkner = Entrenador de Halcones
Fern = Sincero
Fitzgerald = Hijo del Poderoso
Flint = Arroyo
Franklin = Titular libre de la tierra
Franklinn = Titular libre de la tierra
Frayne = Extraño
Gail = Mi padre se regocija alegremente
Gayle = Mi padre se regocija animadamente
Garrin = Lancero
Grantland = De las Grandes Llanuras
Hamilton = Desde el Castillo Fortificado
Harlan = De la tierra
Harold = Líder del ejército
Harris = Hijo del Hombre Fuerte
Holbrook = Desde el arroyo
Hollis = De los acebos
Horton = De la finca del jardín
Hunter = Cazador
Huxley = Del prado del sabio
Irwin = Amigo
Kenneth = Juramento Real
Kenrick = Regla audaz
Kinsey = Relativo
Kingsly = Relativo
Kinslea = Relativo
Kinslee = Relativo
Knox = De las colinas
Landon = Desde el prado herboso
Langley = De la pradera larga
Langston = De la ciudad del hombre alto
Leighton = De la granja de la pradera
Lewis = Salvaguardia del Pueblo
Lincoln = De la ciudad de la piscina
Livingston = De Leif
Locke = Del bosque
Malin = Pequeño guerrero
Mansel = De la casa del pastor
Manton = De la ciudad del héroe
Marland = De la tierra del lago
Maynard = Poderoso
Merlin = Halcón
Montgomery = Montaña de los ricos
Norman = Hombre del norte
Normand = Hombre del norte
Norris = Norteño
Oakley = De los árboles de roble
Ogden = Del valle del roble
Oscar = Lancero divino
Osmond = Protector divino
Palmer = Peregrino pacífico
Patton = De la Ciudad del Guerrero
Paxton = De la ciudad pacífica
Prescott = De la morada del sacerdote
Presley = De la pradera del sacerdote
Preston = Desde la casa del sacerdote
Ramsey = De la isla boscosa
Randoph = Blindaje
Rankin = Escudo pequeño
Reid = Semblante justo
Remington = Desde el hogar del cuervo
Robert = Brillante en el consejo
Bobby = Brillante en el consejo
Robbert = Brillante en el consejo
Roberto = Brillante en el consejo
Robertson = Brillante en el consejo
Rupert = Brillante en el consejo
Rodman = Heroico
Royce = Hijo del rey
Sandord = el lugar del río Sandy Cro
Scott = De Escocia
Shelby = De la finca en la pendiente
Shelbey = De la finca en la pendiente
Stratford = Puente sobre el río
Stuart = Vigilante
Swindel = Del Valle de los Cochinos
Tanner = Peletero
Thane = Seguidor
Tilden = Del bendito valle
Trenton = Pueblo junto a la corriente rápida
Tucker = Carpeta de tela
Wade = Uno que avanza
Walden = Del Valle del Bosque
Ward = guardián
Wardell = Desde la colina del vigilante
Warwick = Desde la presa cercana
Webster = Tejedor
Welby = Desde el Pozo Cercano
Weldon = Desde la colina cerca del pozo
Wellington = Próspero
Wilder = Desde el desierto
Willard = Resuelto y valiente
Winston = Desde la Ciudad Amiga
Winthrop = Desde la casa de un amigo
Woodrow = Del bosque
Woodward = Guardián del bosque
Worrell = Desde el hogar honesto
Worth = Alquería
Wyman = Guerrero
Yale = De la colina