Acton = Assentamento Oak-Tree
Addison = Filho de adão
Afton = De Afton, Inglaterra
Albert = Nobre
Aldrich = Conselheiro Sábio
Alfred = Governante benevolente
Allard = Corajoso
Aric = Santo governante
Audie = Guardião da Propriedade
Baden = Banhista
Barker = pastor
Barrie. = Atiradora
Beldon = Do belo vale
Bentley = Do Prado Grassy
Bertram = Brilhante
Bradley = Do Broad Meadow
Bradlee = Do Broad Meadow
Brandon = Da Colina Flamejante
Brandin = Da Colina Flamejante
Brannan = Da Colina Flamejante
Braxton = Da cidade de Brock
Brock = Texugo
Buddy = Companheiro
Byron = Do celeiro
Biren = Do celeiro
Calvert = Pastor de gado
Camden = Do Vale Sinuoso
Carlise = Corajoso
Carter = Motorista de um carrinho
Chester = Do acampamento
Clayton = Da Propriedade Clay
Clifford = Das alturas do rio
Clifton = Da propriedade do penhasco
Clinton = Da Cidade das Colinas
Dale = De Valley
Dalton = Da cidade do vale
Dane = Trickling Stream
Dhane = Trickling Stream
Darwin = Amado
Dean = Vale
Edmund = Abençoada paz
Edmond = Abençoada paz
Edric = Poderoso com propriedade
Edward = Nomeado para Proteger
Eddy = Nomeado para Proteger
Edwin = Amigo próspero
Elden = Wise Guardian
Eldred = Conselheiro de Idosos
Elmer = Famoso
Emmet = Séria
Emmit = Séria
Emmott = Séria
Esmond = Protetor Rico
Falkner = Treinador de Falcões
Fern = Sincero
Fitzgerald = Filho do poderoso
Flint = Stream
Franklin = Titular Livre de Terra
Franklinn = Titular Livre de Terra
Frayne = Desconhecido
Gail = Meu pai se alegra animadamente
Gayle = Meu pai se alegra animadamente
Garrin = Lanceiro
Grantland = Das Grandes Planícies
Hamilton = Do Castelo Fortificado
Harlan = Da terra
Harold = Líder do exército
Harris = Filho do homem forte
Holbrook = Do riacho
Hollis = Das árvores de azevinho
Horton = Da Garden Estate
Hunter = Caçador
Huxley = Do Prado do Homem Sábio
Irwin = Amigo
Kenneth = Juramento real
Kenrick = Régua Ousada
Kinsey = Relativo
Kingsly = Relativo
Kinslea = Relativo
Kinslee = Relativo
Knox = Das colinas
Landon = Do Prado Grassy
Langley = Do Long Meadow
Langston = Da cidade do homem alto
Leighton = Da Fazenda Meadow
Lewis = Salvaguarda do Povo
Lincoln = Da cidade da piscina
Livingston = De Leif
Locke = Da floresta
Malin = Pequeno guerreiro
Mansel = Da casa do pastor
Manton = Da Cidade do Herói
Marland = Da Terra do Lago
Maynard = Poderoso
Merlin = Falcão
Montgomery = Montanha dos ricos
Norman = Homem do Norte
Normand = Homem do Norte
Norris = Nortista
Oakley = Dos Carvalhos
Ogden = De Oak Valley
Oscar = Lanceiro divino
Osmond = Protetor divino
Palmer = Peregrino pacífico
Patton = Da Cidade do Guerreiro
Paxton = Da cidade pacífica
Prescott = Da Morada do Sacerdote
Presley = Do Priest's Meadow
Preston = Da Casa do Sacerdote
Ramsey = Da Ilha Wooded
Randoph = Escudo
Rankin = Escudo Pequeno
Reid = Rosto justo
Remington = Da Casa do Corvo
Robert = Brilhante no Conselho
Bobby = Brilhante no Conselho
Robbert = Brilhante no Conselho
Roberto = Brilhante no Conselho
Robertson = Brilhante no Conselho
Rupert = Brilhante no Conselho
Rodman = Heróico
Royce = Filho do rei
Sandord = o lugar do Sandy River Cro
Scott = Da Escócia
Shelby = Da propriedade na encosta
Shelbey = Da propriedade na encosta
Stratford = Ponte sobre o rio
Stuart = Zelador
Swindel = Do Vale dos Porcos
Tanner = Coureiro
Thane = Seguidor
Tilden = Do Vale Abençoado
Trenton = Cidade perto do Riacho Rápido
Tucker = Pasta de pano
Wade = Aquele que avança
Walden = Do Vale da Floresta
Ward = Guardião
Wardell = Da Colina do Vigia
Warwick = Da Barragem Perto
Webster = Tecelão
Welby = Do Poço Próximo
Weldon = De Hill Perto do Poço
Wellington = Próspero
Wilder = Da Terra Selvagem
Willard = Resoluto e valente
Winston = Da Cidade Amigável
Winthrop = Da casa do amigo
Woodrow = Da floresta
Woodward = Forest Warden
Worrell = Do Lar Honesto
Worth = Farmstead
Wyman = Guerreiro
Yale = Da colina