Acton = Règlement des chênes
Addison = Fils d'Adam
Afton = Depuis Afton, Angleterre
Albert = noble
Aldrich = Conseiller sage
Alfred = Souverain bienveillant
Allard = Courageux
Aric = Saint souverain
Audie = Gardien de propriété
Baden = Baigneur
Barker = Berger
Barrie. = tireuse d'élite
Beldon = De la belle vallée
Bentley = De la prairie herbeuse
Bertram = Brillant
Bradley = De la large prairie
Bradlee = De la large prairie
Brandon = De la Colline Flamboyante
Brandin = De la Colline Flamboyante
Brannan = De la Colline Flamboyante
Braxton = De la ville de Brock
Brock = Blaireau
Buddy = Un compagnon
Byron = De la grange
Biren = De la grange
Calvert = Éleveur de bétail
Camden = De la vallée sinueuse
Carlise = Courageux
Carter = Conducteur d'un chariot
Chester = Depuis le camping
Clayton = Du domaine d'argile
Clifford = Depuis les hauteurs de la rivière
Clifton = Du domaine de la falaise
Clinton = De la ville de la colline
Dale = De la vallée
Dalton = De la ville de la vallée
Dane = Flux de ruissellement
Dhane = Flux de ruissellement
Darwin = Bien-aimé
Dean = Vallée
Edmund = Paix bénie
Edmond = Paix bénie
Edric = Puissant Avec Propriété
Edward = Nommé pour protéger
Eddy = Nommé pour protéger
Edwin = Ami prospère
Elden = Gardien sage
Eldred = Conseiller pour personnes âgées
Elmer = Célèbre
Emmet = Sérieux
Emmit = Sérieux
Emmott = Sérieux
Esmond = Protecteur riche
Falkner = Dresseur de faucons
Fern = Sincère
Fitzgerald = Fils du Puissant
Flint = Flux
Franklin = Libre Titulaire de Terre
Franklinn = Libre Titulaire de Terre
Frayne = Étranger
Gail = Mon père se réjouit vivement
Gayle = Mon père se réjouit vivement
Garrin = Lancier
Grantland = Des Grandes Plaines
Hamilton = Depuis le château fort
Harlan = De la terre
Harold = Chef d'armée
Harris = Fils de l'homme fort
Holbrook = Du ruisseau
Hollis = Des arbres de houx
Horton = Du domaine du jardin
Hunter = chasseur
Huxley = De la prairie du sage
Irwin = Ami
Kenneth = Serment Royal
Kenrick = Règle audacieuse
Kinsey = Relatif
Kingsly = Relatif
Kinslea = Relatif
Kinslee = Relatif
Knox = Depuis les collines
Landon = De la prairie herbeuse
Langley = De la longue prairie
Langston = De la ville du grand homme
Leighton = De la ferme des prés
Lewis = Sauvegarde du peuple
Lincoln = De la ville de la piscine
Livingston = De Leif
Locke = De la forêt
Malin = Petit guerrier
Mansel = De la maison du pasteur
Manton = De la ville des héros
Marland = Du Pays du Lac
Maynard = Puissant
Merlin = Faucon
Montgomery = Montagne des riches
Norman = L'homme du nord
Normand = L'homme du nord
Norris = Nordiste
Oakley = Des chênes
Ogden = De la vallée des chênes
Oscar = Lancier divin
Osmond = Protecteur divin
Palmer = Pèlerin paisible
Patton = De la ville des guerriers
Paxton = De la ville paisible
Prescott = De la demeure du prêtre
Presley = De la prairie du prêtre
Preston = De la maison du prêtre
Ramsey = De l'île boisée
Randoph = Bouclier
Rankin = Petit Bouclier
Reid = Contenance juste
Remington = De la maison du corbeau
Robert = Brillant en conseil
Bobby = Brillant en conseil
Robbert = Brillant en conseil
Roberto = Brillant en conseil
Robertson = Brillant en conseil
Rupert = Brillant en conseil
Rodman = Héroïque
Royce = Fils du roi
Sandord = la place de la rivière Sandy Cro
Scott = De l'Ecosse
Shelby = Du Domaine sur la Piste
Shelbey = Du Domaine sur la Piste
Stratford = Pont sur la rivière
Stuart = Le concierge
Swindel = De la Vallée des Cochons
Tanner = Travailleur du cuir
Thane = Disciple
Tilden = De la vallée bénie
Trenton = Ville par le ruisseau rapide
Tucker = Dossier de tissu
Wade = Celui qui avance
Walden = De la vallée forestière
Ward = Gardien
Wardell = De la colline du gardien
Warwick = Du près du barrage
Webster = Tisserand
Welby = Du Puits Proche
Weldon = De la colline près du puits
Wellington = Prospère
Wilder = Du désert
Willard = Résolu et courageux
Winston = De la ville amicale
Winthrop = De la maison de l'ami
Woodrow = Des bois
Woodward = Garde forestier
Worrell = De la maison honnête
Worth = Ferme
Wyman = guerrier
Yale = De la Colline